1111111111111111
1P0000000000CCC1
1000000000000001
1E00000000000001
1111111111111111
