111111111
1P000CCC1
100000001
1E0000001
111111111
