111111111
1P000C001
100000001
100000001
100000B01
10E0000C1
100C00B01
111111111
